0000000000010000
0000000000001000
0001000111100100
0001000000110010
0001110000000000
0000000000000000
0000010001111000
0000010000010000
0000010000010000